12
        . . . . . . . .
    + + . . . . . . . .
    +   . . . . . . . .
    +             +     
. . . . . . L     + + +
. . . . . . .         +
. . . . . . .         +
. . . . . . .         +
. . . . . . .         +
. . . . . . . + + + + +          
. . . . . . .          
. . . . . @ . + + + + +
