10
. . . . . . .      
. . . . . . .      
. . Q . . . .      
. . . . . . .      
. . . . @ . .      
. . . . . . .      
. . . . . . .      
. . . . . . .      
. . . . . . . +    
            + . . .
