19
+ + + + + + + + +   + + + + + + + + +
+         +               +         +
+         +               +         +
+     . . . . .       . . . . .     +
      . . . . .       . . . . .     +
+ + + . . E . . + + + . . . . . +   +
+     . . . . .       . . . . .     +
+     . . . . .       . . . . .     +
+         +               +         +
+                                   +
+         +               +         +
+     . . . . .       . . . . .     +
      . . . . .       . . . . .     +
+ + + . . . . . +   + . . . . . + + +
+     . . . . .       . . . . .     +
+     . . . . .       . . . . @     +
+         +               +         +
+         +               +         +
+   + + + + + + + + + + + + + + +   +
